# # # # # # # # # #
# 0   #       #   #
#     #       #   #
#         # #     #
#   # # #         #
#       #         #
#   #       #     #
#   # # #   # #   #
# #             1 #
# # # # # # # # # #